19 18 18 19 18 18 18 18 19 18 18 19 18 18 18 18 19 18 18 18 19 18 18 19 18 19 18 18 19 18 18 19 18 18 19 18 19 18 18 19 18 19 18 18 19 18 19 18 18 19 18
19 18 18 19 18 18 19 18 18 18 19 18 18 19 18 18 18 18 19 18 18 18 19 18 18 18 19 18 18 18 19 18 18 18 18 19 18 18 18 18 19 18 18 19 18 18 19 18 18 19 18
18 18 18 18 19 18 18 18 18 18 18 19 18 18 18 18 19 18 19 18 19 18 18 18 18 18 19 18 19 18 18 18 18 18 19 18 18 18 18 19 18 18 18 18 18 19 18 18 18 18 19
19 18 18 19 18 18 18 18 19 18 18 19 18 18 18 18 19 18 18 18 19 18 18 19 18 19 18 18 19 18 18 19 18 18 19 18 19 18 18 19 18 19 18 18 19 18 19 18 18 19 18
18 18 18 19 18 18 18 19 19 18 18 18 19 18 18 18 18 19 19 18 18 19 18 19 18 18 19 19 18 19 18 19 19 18 18 19 19 19 19 19 18 18 18 18 18 19 18 18 18 19 18
18 18 19 19 18 18 18 18 19 18 18 19 18 19 18 18 19 18 18 18 18 18 19 18 18 18 18 18 18 19 18 18 18 18 19 18 18 18 19 18 18 18 19 18 19 18 18 19 18 18 19
18 18 18 19 19 18 18 18 18 18 18 19 18 18 18 18 18 19 18 18 18 18 18 18 19 18 18 18 18 18 18 18 19 18 18 18 18 18 18 18 18 18 19 18 18 18 18 18 18 19 18
18 18 18 18 18 19 18 18 18 18 18 18 19 18 18 18 18 18 18 18 18 18 19 18 18 18 19 18 18 18 18 19 18 18 18 18 18 18 18 19 18 18 18 18 18 19 18 18 18 18 18
18 18 19 18 18 18 18 18 19 18 18 18 18 18 18 18 18 18 18 18 19 18 18 18 18 18 18 18 18 18 18 18 18 19 18 18 18 18 18 18 18 19 18 18 18 18 18 19 18 18 18
18 19 18 18 19 18 19 18 28 26 26 26 26 26 26 26 26 26 26 26 26 26 26 26 26 26 26 26 26 26 26 26 26 26 26 26 26 26 26 26 26 26 29 18 18 18 18 18 18 19 18 18 18 19 18 18 18 19 18 18 19 18
18 18 19 18 18 18 19 18 24 1 0 0 1 0 1 0 15 0 1 0 0 1 0 1 7 2 6 0 0 1 15 0 1 0 1 0 1 0 0 0 1 0 23 18 18 19 18 18 18 19 18
18 19 18 19 18 19 18 18 24 0 0 0 1 0 1 0 0 0 1 0 0 1 15 0 7 2 6 0 1 0 1 0 1 0 0 0 1 0 0 1 0 0 23 18 19 18 19 18 19 18 18
19 18 18 19 18 19 18 18 24 1 0 15 0 0 1 0 1 0 1 0 0 0 1 0 7 2 6 0 1 0 1 0 0 1 0 1 0 1 32 15 0 1 23 19 18 18 19 18 19 18 18
19 19 18 19 18 19 18 19 24 0 0 0 1 0 0 1 15 1 1 0 0 0 0 0 7 2 6 0 20 21 21 21 21 21 21 21 21 21 22 0 1 0 23 19 19 18 19 18 19 18 19
19 18 18 19 18 19 18 18 24 0 1 0 0 1 0 0 0 0 1 0 1 0 1 0 7 2 6 1 23 18 19 18 18 19 18 19 18 18 24 0 1 0 23 19 18 18 19 18 19 18 18
18 19 18 19 19 18 19 18 24 1 0 1 0 0 1 0 1 0 1 0 0 1 0 1 7 2 6 0 23 19 18 19 18 19 18 18 18 18 24 1 0 0 23 18 19 18 19 19 18 19 18
18 18 18 18 18 18 18 18 24 0 0 1 0 1 0 1 1 0 1 0 0 1 0 1 7 2 6 1 23 18 18 18 18 18 19 18 19 18 24 1 0 15 23 18 18 18 18 18 18 18 18
18 18 19 18 18 19 19 18 24 0 1 32 1 0 1 0 0 1 0 1 0 1 0 1 7 2 6 0 23 18 19 18 18 19 18 28 26 26 27 0 1 0 23 18 18 19 18 18 19 19 18
18 18 19 19 18 18 18 18 24 0 1 1 0 0 1 0 1 15 1 0 1 0 1 0 7 2 6 1 23 19 18 19 18 18 19 24 1 1 0 1 0 1 23 18 18 19 19 18 18 18 18
18 18 19 18 18 19 19 18 24 0 1 0 1 0 1 0 1 0 1 0 1 0 1 0 7 2 6 0 25 26 26 26 26 26 26 27 1 0 1 1 1 1 23 18 18 19 18 18 19 19 18
18 18 18 18 19 18 18 18 24 0 0 1 15 0 0 1 0 0 0 1 0 1 0 0 7 2 6 1 0 1 0 0 0 1 0 0 1 0 1 0 1 0 23 18 18 18 18 19 18 18 18
18 19 18 18 18 18 18 18 24 1 0 1 0 1 0 0 1 0 15 0 1 0 1 0 7 2 6 0 1 0 1 1 0 1 0 1 0 0 15 0 1 1 23 18 19 18 18 18 18 18 18
18 18 18 18 19 18 18 18 24 0 1 0 1 0 0 1 0 1 0 1 0 1 0 1 7 2 6 1 0 1 0 1 0 1 1 0 1 0 0 1 0 1 23 18 18 18 18 19 18 18 18
19 18 18 18 18 18 18 18 24 0 1 0 1 0 32 0 1 1 0 1 0 1 1 0 7 2 6 0 1 1 0 1 15 1 0 1 0 0 1 0 1 0 23 19 18 18 18 18 18 18 18
18 18 19 19 19 18 19 18 24 9 9 9 9 9 9 9 9 9 9 9 9 9 9 9 10 2 8 9 9 9 9 9 9 9 9 9 9 9 9 9 9 9 23 18 18 19 19 19 18 19 18
18 18 18 18 18 19 18 19 24 2 2 2 2 2 2 2 2 2 2 2 2 2 2 2 2 2 2 2 2 2 2 2 2 2 2 2 2 2 2 2 2 2 23 18 18 18 18 18 19 18 19
18 19 18 18 19 18 18 18 24 4 4 4 4 4 4 4 4 4 4 4 4 4 4 4 5 2 3 4 4 4 4 4 4 4 4 4 4 4 4 4 4 4 23 18 19 18 18 19 18 18 18
18 18 19 18 18 18 19 18 24 1 0 1 0 0 1 0 1 0 1 15 0 0 1 0 7 2 6 0 1 0 1 0 0 1 0 1 0 1 15 1 0 1 23 18 18 19 18 18 18 19 18
18 18 18 18 18 18 18 18 24 0 0 0 1 0 0 1 0 1 1 0 0 0 0 0 7 2 6 0 0 0 0 1 0 0 0 0 0 0 1 0 1 0 23 18 18 18 18 18 18 18 18
18 18 19 19 18 19 19 18 24 0 1 0 0 1 0 0 0 0 1 15 1 0 1 0 7 2 6 1 0 1 0 0 0 1 0 0 0 1 0 0 1 0 23 18 18 19 19 18 19 19 18
18 18 18 18 19 19 19 18 24 1 0 1 0 0 1 0 1 0 1 0 0 1 0 1 7 2 6 0 0 1 0 15 1 0 1 15 0 1 0 1 0 0 23 18 18 18 18 19 19 19 18
19 19 19 19 18 19 19 19 24 0 0 1 0 1 0 1 1 0 1 0 0 1 0 1 7 2 6 1 0 1 0 1 0 1 1 0 15 1 0 1 0 1 23 19 19 19 19 18 19 19 19
19 18 18 19 19 19 18 19 24 0 1 15 1 0 1 0 0 1 0 1 0 1 0 1 7 2 6 0 1 0 1 0 1 0 1 0 1 0 15 0 1 0 23 19 18 18 19 19 19 18 19
19 18 19 18 18 19 18 18 24 0 1 1 0 0 15 0 15 0 1 0 15 0 1 0 7 2 6 1 0 1 0 1 0 0 1 1 0 1 0 1 0 1 23 19 18 19 18 18 19 18 18
18 19 19 18 19 18 19 18 24 0 1 0 1 0 1 0 1 32 1 0 1 0 1 0 7 2 6 0 15 0 1 0 1 0 1 0 1 0 1 1 1 1 23 18 19 19 18 19 18 19 18
18 18 18 19 18 19 18 19 24 0 0 1 0 0 0 1 0 0 0 1 0 1 0 0 7 2 6 1 0 1 0 0 0 15 0 0 1 0 1 0 1 0 23 18 18 18 19 18 19 18 19
18 18 19 18 18 18 19 18 24 1 0 1 0 1 0 15 1 0 1 15 1 0 1 0 7 2 6 0 1 0 1 15 0 32 0 1 0 0 1 0 1 1 23 18 18 19 18 18 18 19 18
18 18 19 19 18 18 19 18 24 0 1 0 15 0 0 1 0 1 0 1 0 1 0 1 7 2 6 1 0 1 0 1 0 1 1 0 1 0 0 1 0 1 23 18 18 19 19 18 18 19 18
18 19 18 19 18 19 18 18 24 0 1 0 1 0 1 0 1 1 0 1 0 1 1 0 7 2 6 0 1 1 0 1 0 1 0 1 0 0 1 0 1 0 23 18 19 18 19 18 19 18 18
18 19 18 18 19 18 19 18 24 1 1 0 1 0 0 1 0 1 0 15 0 1 0 0 7 2 6 0 1 0 1 0 0 1 1 0 1 0 1 0 1 1 23 18 19 18 18 19 18 19 18
18 18 19 18 19 19 18 19 24 0 1 0 1 0 1 0 1 0 1 0 1 0 1 0 7 2 6 0 1 0 1 0 1 0 1 0 1 0 1 1 1 1 23 18 18 19 18 19 19 18 19
18 18 18 19 18 18 19 18 30 21 21 21 21 21 21 21 21 21 21 21 21 21 21 21 21 21 21 21 21 21 21 21 21 21 21 21 21 21 21 21 21 21 31 18 18 19 18 19 18 18 18 19 18 19 18 19 18 19 18 19 18 19
18 19 18 19 18 18 19 18 19 18 18 19 18 19 18 18 19 18 18 19 18 18 19 18 18 18 18 18 19 18 18 18 18 19 18 18 18 19 18 18 18 18 19 18 18 18 19 18 19 18 19
18 18 19 18 19 18 18 18 18 19 18 18 18 19 18 18 18 18 19 18 18 18 19 18 18 19 18 18 18 19 18 19 18 18 18 19 18 18 18 19 18 19 18 18 18 19 18 19 18 18 19
18 18 18 19 18 19 18 18 18 19 18 18 19 18 18 18 19 18 18 18 19 18 18 18 19 18 18 19 18 18 19 18 18 18 18 19 18 18 18 18 18 19 18 18 18 19 18 18 18 18 19
18 18 18 19 18 18 18 19 18 18 18 19 18 18 18 19 18 18 19 18 18 19 18 18 18 18 19 18 18 19 18 18 19 18 18 18 19 18 19 18 18 18 19 18 18 19 18 18 18 19 18
19 18 18 18 19 18 19 18 18 18 18 19 18 18 18 19 18 19 18 19 18 18 19 18 18 18 19 18 18 19 18 19 18 18 19 18 19 18 18 19 18 19 18 18 19 18 19 18 19 18 18
19 18 19 18 19 18 18 19 18 18 18 19 18 19 18 18 19 18 19 18 19 18 18 18 19 18 18 18 19 18 18 18 18 18 19 18 18 18 18 19 18 18 18 18 18 18 19 18 18 18 19
18 18 18 19 18 18 18 18 19 18 18 18 18 18 18 19 18 18 18 19 18 18 18 19 18 18 18 18 19 18 19 18 18 18 19 18 18 19 18 19 18 18 19 18 18 19 18 18 19 18 19
18 18 18 19 18 18 18 18 19 18 18 18 18 19 18 18 18 18 19 18 18 19 18 18 18 19 18 18 19 18 18 19 18 18 18 19 18 18 19 18 19 18 18 19 18 19 18 19 18 19 18
18 19 18 19 18 19 18 18 19 18 19 18 19 18 19 18 18 19 18 19 18 19 18 19 18 19 18 18 19 18 19 18 19 18 19 18 19 18 19 18 19 18 19 18 19 18 19 18 19 18 19