3 8 3 8 3 8 3 8 3 8 3 8 3 8 3 8 3 8 3 8 3 8 3
3 1 2 1 6 6 6 6 6 6 6 8 1 2 1 2 2 1 3 5 3 4 8
1 1 1 2 6 2 1 2 4 2 6 9 1 1 2 1 2 1 2 4 2 1 3
1 3 2 1 6 2 1 2 2 5 6 8 3 2 1 1 2 1 2 2 5 3 8
1 1 2 2 6 1 1 3 1 3 3 8 1 2 2 1 1 1 3 1 3 1 3
2 1 2 1 6 1 1 3 1 1 6 9 1 2 1 5 1 1 2 1 1 2 8
1 2 2 1 6 3 2 2 2 2 6 8 2 2 1 1 3 2 1 2 2 3 3
1 1 1 2 6 6 6 6 6 6 6 8 1 1 2 1 2 1 2 4 2 1 8
1 3 2 1 1 2 1 2 2 5 6 9 6 2 1 1 2 1 2 2 5 3 3
1 4 0 2 1 4 3 1 1 6 9 8 9 6 2 1 4 3 1 1 1 4 8
1 0 0 1 0 2 3 3 6 9 8 9 8 8 6 0 2 3 3 2 1 5 8
8 9 8 8 9 9 9 8 8 9 8 9 8 8 8 9 8 9 8 8 9 9 3
2 3 1 1 1 2 1 1 6 9 9 9 9 9 6 1 2 1 1 2 3 2 8
3 1 2 1 2 2 1 3 5 6 9 8 9 6 1 2 2 1 3 5 3 4 3
1 1 2 2 1 1 1 3 1 3 6 9 6 2 2 1 1 1 3 1 3 1 8
2 1 2 1 5 1 1 2 1 1 2 9 1 2 1 5 1 1 2 1 1 2 3
1 2 2 1 1 3 2 1 2 2 3 8 2 2 1 1 3 2 1 2 2 3 8
1 4 0 2 1 4 3 1 1 1 4 8 4 0 2 1 4 3 1 1 1 4 3
1 0 0 1 0 2 3 3 2 1 5 9 0 0 1 0 2 3 3 2 1 5 8
0 4 2 5 0 2 1 2 4 1 1 8 4 2 5 0 2 1 2 4 1 1 3
1 2 2 1 1 3 2 1 2 2 3 8 2 2 1 1 3 2 1 2 2 3 8
1 2 2 1 1 3 2 1 2 2 3 8 2 2 1 1 3 2 1 2 2 3 3
3 8 3 8 3 8 3 8 3 8 3 8 3 8 3 8 3 8 3 8 3 8 8