18 18 18 18 18 18 18 18 18 18 18 18 18 18 18 18 18 18 18 18 18 18 18 18 18 18 18 18 18 18 18 18 18 18 18 18 18 18 18 18 18 18 18 18 18 18 18 18 18 18 18 18 18 18 18 18 18 18 18 18 18 18 18 18 18 18 18
18 18 18 18 18 18 18 18 18 18 18 18 18 18 18 18 18 18 18 18 18 18 18 18 18 18 18 18 18 18 18 18 18 18 18 18 18 18 18 18 18 18 18 18 18 18 18 18 18 18 18 18 18 18 18 18 18 18 18 18 18 18 18 18 18 18 18
18 18 18 18 18 18 18 18 18 18 18 18 18 18 18 18 18 18 18 18 18 18 18 18 18 18 18 18 18 18 18 18 18 18 18 18 18 18 18 18 18 18 18 18 18 18 18 18 18 18 18 18 18 18 18 18 18 18 18 18 18 18 18 18 18 18 18
18 18 18 18 18 18 18 18 18 18 18 18 18 18 18 18 18 18 18 18 18 18 18 18 18 18 18 18 18 18 18 18 18 18 18 18 18 18 18 18 18 18 18 18 18 18 18 18 18 18 18 18 18 18 18 18 18 18 18 18 18 18 18 18 18 18 18
18 18 18 18 18 18 18 18 18 18 18 18 18 18 18 18 18 18 18 18 18 18 18 18 18 18 18 18 18 18 18 18 18 18 18 18 18 18 18 18 18 18 18 18 18 18 18 18 18 18 18 18 18 18 18 18 18 18 18 18 18 18 18 18 18 18 18
18 18 18 18 18 18 18 18 18 18 18 18 18 18 18 18 18 18 18 18 18 18 18 18 18 18 18 18 18 18 18 18 18 18 18 18 18 18 18 18 18 18 18 18 18 18 18 18 18 18 18 18 18 18 18 18 18 18 18 18 18 18 18 18 18 18 18
18 18 18 18 18 18 18 18 18 18 18 18 18 18 18 18 18 18 18 18 18 18 18 18 18 18 18 18 18 18 18 18 18 18 18 18 18 18 18 18 18 18 18 18 18 18 18 18 18 18 18 18 18 18 18 18 18 18 18 18 18 18 18 18 18 18 18
18 18 18 18 18 18 18 18 28 26 26 26 26 26 26 26 26 26 26 26 26 26 26 26 26 26 26 26 26 26 26 26 26 26 26 26 26 26 26 26 26 26 26 26 26 26 26 26 26 26 26 26 26 26 26 26 26 26 26 29 18 18 18 18 18 18 18
18 18 18 18 18 18 18 18 24 00 00 00 00 00 00 00 00 00 00 00 00 00 00 00 00 00 00 00 00 00 00 00 00 00 00 00 00 00 00 00 00 00 00 00 00 00 00 00 00 00 00 00 00 00 00 00 00 00 00 23 18 18 18 18 18 18 18
18 18 18 18 18 18 18 18 24 00 00 00 00 00 00 00 00 00 00 00 00 00 00 00 00 00 00 00 00 00 00 00 00 00 00 00 00 00 00 00 00 00 00 00 00 00 00 00 00 00 00 00 00 00 00 00 00 00 00 23 18 18 18 18 18 18 18
18 18 18 18 18 18 18 18 24 00 00 00 00 00 00 00 00 00 00 00 00 00 00 00 00 00 00 00 00 00 00 00 00 00 00 00 00 00 00 00 00 00 00 00 00 00 00 00 00 00 00 00 00 00 00 00 00 00 00 23 18 18 18 18 18 18 18
18 18 18 18 18 18 18 18 24 00 00 00 00 00 00 00 00 00 00 00 00 00 00 00 00 00 00 00 00 00 00 00 00 00 00 00 00 00 00 00 00 00 00 00 00 00 00 00 00 00 00 00 00 00 00 00 00 00 00 23 18 18 18 18 18 18 18
18 18 18 18 18 18 18 18 24 00 00 00 00 00 00 00 00 00 00 00 00 00 00 00 00 00 00 00 00 00 00 00 00 00 00 00 00 00 00 00 00 00 00 00 00 18 18 18 18 18 00 00 00 00 00 00 00 00 00 23 18 18 18 18 18 18 18
18 18 18 18 18 18 18 18 24 00 00 00 00 00 00 00 00 00 00 00 00 00 00 00 00 00 00 00 00 00 00 00 00 00 00 00 00 00 00 00 00 00 00 18 18 18 18 18 18 18 18 00 00 00 00 00 00 00 00 23 18 18 18 18 18 18 18
18 18 18 18 18 18 18 18 24 00 00 00 00 00 00 00 00 00 00 00 00 00 00 00 00 00 00 00 00 00 00 00 00 00 00 00 00 00 00 00 23 18 18 18 18 18 18 18 18 18 18 18 18 00 00 00 00 00 00 23 18 18 18 18 18 18 18
18 18 18 18 18 18 18 18 24 00 00 00 00 11 09 09 09 09 09 09 09 12 00 00 00 00 00 00 00 00 00 00 00 00 00 00 00 00 00 00 23 18 18 18 18 18 18 18 18 18 18 18 18 18 00 00 00 00 00 23 18 18 18 18 18 18 18
18 18 18 18 18 18 18 18 24 00 00 00 00 07 02 02 02 02 02 02 02 06 00 00 00 00 00 00 00 00 00 00 00 00 00 00 00 00 00 00 22 18 18 18 18 18 18 18 18 18 18 18 18 18 00 00 00 00 00 23 18 18 18 18 18 18 18
18 18 18 18 18 18 18 18 24 00 00 00 00 13 04 04 04 04 04 05 02 06 00 00 00 00 00 00 00 00 00 00 00 00 00 00 00 00 00 00 00 00 00 18 18 18 18 18 18 18 18 18 18 18 18 00 00 00 00 23 18 18 18 18 18 18 18
18 18 18 18 18 18 18 18 24 00 00 00 00 00 00 00 00 00 00 07 02 06 00 00 00 00 00 00 00 00 00 00 00 00 00 00 00 00 00 00 00 00 00 18 18 18 18 18 18 18 18 18 18 18 18 00 00 00 00 23 18 18 18 18 18 18 18
18 18 18 18 18 18 18 18 24 00 00 00 00 00 00 00 00 00 00 07 02 06 00 00 00 00 00 00 00 00 00 00 00 00 00 00 00 00 00 00 00 00 00 00 00 18 18 18 18 18 18 18 18 18 18 00 00 00 00 23 18 18 18 18 18 18 18
18 18 18 18 18 18 18 18 24 00 00 00 00 00 00 00 00 00 00 07 02 06 00 00 00 00 00 00 00 00 00 00 00 00 00 00 00 00 00 00 00 00 00 00 00 00 18 18 18 18 18 18 18 18 18 00 00 00 00 23 18 18 18 18 18 18 18
18 18 18 18 18 18 18 18 24 00 00 00 00 00 00 00 00 00 00 07 02 06 00 00 00 00 00 00 00 00 00 00 00 00 00 00 00 00 00 00 00 00 00 00 00 00 00 00 18 18 18 18 18 18 18 00 00 00 00 23 18 18 18 18 18 18 18
18 18 18 18 18 18 18 18 24 00 00 00 00 00 00 00 00 00 00 07 02 06 00 00 00 00 00 00 00 00 00 00 00 00 00 00 00 00 00 00 00 00 00 00 00 00 00 00 00 00 18 18 18 18 00 00 00 00 00 23 18 18 18 18 18 18 18
18 18 18 18 18 18 18 18 24 00 00 00 00 00 00 00 00 00 00 07 02 06 00 00 00 00 00 00 00 00 00 00 00 00 00 00 00 00 00 00 00 00 00 00 00 00 00 00 00 00 00 18 18 18 00 00 00 00 00 23 18 18 18 18 18 18 18
18 18 18 18 18 18 18 18 24 00 00 00 00 00 00 00 00 00 00 07 02 06 00 00 00 00 00 00 00 00 00 00 00 00 00 00 00 00 00 00 00 00 00 00 00 00 00 00 00 00 00 00 18 00 00 00 00 00 00 23 18 18 18 18 18 18 18
18 18 18 18 18 18 18 18 24 00 00 00 00 00 00 00 00 00 00 07 02 08 09 09 09 09 09 09 09 09 09 09 09 09 09 09 09 09 09 09 09 09 09 09 09 09 09 12 00 00 00 00 00 00 00 00 00 00 00 23 18 18 18 18 18 18 18
18 18 18 18 18 18 18 18 24 00 00 00 00 00 00 00 00 00 00 07 02 02 02 02 02 02 02 02 02 02 02 02 02 02 02 02 02 02 02 02 02 02 02 02 02 02 02 06 00 00 00 00 00 00 00 00 00 00 00 23 18 18 18 18 18 18 18
18 18 18 18 18 18 18 18 24 00 00 00 00 00 00 00 00 00 00 07 02 06 04 04 04 04 04 04 04 04 04 04 04 04 04 04 04 04 04 04 04 04 04 04 04 04 04 14 00 00 00 00 00 00 00 00 00 00 00 23 18 18 18 18 18 18 18
18 18 18 18 18 18 18 18 24 00 00 00 00 00 00 00 00 00 00 07 02 06 00 00 00 00 00 00 00 00 00 00 00 00 00 00 00 00 00 00 00 00 00 00 00 00 00 00 00 00 00 00 00 00 00 00 00 00 00 23 18 18 18 18 18 18 18
18 18 18 18 18 18 18 18 24 00 00 00 00 00 00 00 00 00 00 07 02 06 00 00 00 00 00 00 00 00 00 00 00 00 00 00 00 00 00 00 00 00 00 00 00 00 00 00 00 00 00 00 00 00 00 00 00 00 00 23 18 18 18 18 18 18 18
18 18 18 18 18 18 18 18 24 00 00 00 00 00 00 00 00 00 00 07 02 06 00 00 00 00 00 00 00 00 00 00 00 00 00 00 00 00 00 00 00 00 00 00 00 00 00 00 00 00 00 00 00 00 00 00 00 00 00 23 18 18 18 18 18 18 18
18 18 18 18 18 18 18 18 24 00 00 00 00 00 00 00 00 00 00 07 02 06 00 00 00 00 00 00 00 00 00 00 00 00 00 00 00 00 00 00 00 00 00 00 00 00 00 00 00 00 00 00 00 00 00 00 00 00 00 23 18 18 18 18 18 18 18
18 18 18 18 18 18 18 18 24 00 00 00 00 00 00 00 00 00 00 07 02 06 00 00 00 00 00 00 00 00 00 00 00 00 00 00 00 00 00 00 00 00 00 00 00 00 00 00 00 00 00 00 00 00 00 00 00 00 00 23 18 18 18 18 18 18 18
18 18 18 18 18 18 18 18 24 00 00 00 00 00 00 00 00 00 00 07 02 06 00 00 00 00 00 00 00 00 00 00 00 00 00 00 00 00 00 00 00 00 00 00 00 00 00 00 00 00 00 00 00 00 00 00 00 00 00 23 18 18 18 18 18 18 18
18 18 18 18 18 18 18 18 24 00 00 00 00 00 00 00 00 00 00 07 02 06 00 00 00 00 00 00 00 00 00 00 00 00 00 00 00 00 00 00 00 00 00 00 00 00 00 00 00 00 00 00 00 00 00 00 00 00 00 23 18 18 18 18 18 18 18
18 18 18 18 18 18 18 18 24 00 00 00 00 00 00 00 00 00 00 07 02 06 00 00 00 00 00 00 00 00 00 00 00 00 00 00 00 00 00 00 00 00 00 00 00 00 00 00 00 00 00 00 00 00 00 00 00 00 00 23 18 18 18 18 18 18 18
18 18 18 18 18 18 18 18 24 00 00 00 00 00 00 00 00 00 00 07 02 06 00 00 00 00 00 00 00 00 00 00 00 00 00 00 00 00 00 00 00 00 00 00 00 00 00 00 00 00 00 00 00 00 00 00 00 00 00 23 18 18 18 18 18 18 18
18 18 18 18 18 18 18 18 24 00 00 00 00 00 00 00 00 00 00 07 02 06 00 00 00 00 00 00 00 00 00 00 00 00 00 00 00 00 00 00 00 00 00 00 00 00 00 00 00 00 00 00 00 00 00 00 00 00 00 23 18 18 18 18 18 18 18
18 18 18 18 18 18 18 18 24 00 00 00 00 00 00 00 00 00 00 07 02 06 00 00 00 00 00 00 00 00 00 00 00 00 00 00 00 00 00 00 00 00 00 00 00 00 00 00 00 00 00 00 00 00 00 00 00 00 00 23 18 18 18 18 18 18 18
18 18 18 18 18 18 18 18 24 00 00 00 00 00 00 00 00 00 00 07 02 06 00 00 00 00 00 00 00 00 00 00 00 00 00 00 00 00 00 00 00 00 00 00 00 00 00 00 00 00 00 00 00 00 00 00 00 00 00 23 18 18 18 18 18 18 18
18 18 18 18 18 18 18 18 24 00 00 00 00 00 00 00 00 00 00 07 02 06 00 00 00 00 00 00 00 00 00 00 00 00 00 00 00 00 00 00 00 00 00 00 00 00 00 00 00 00 00 00 00 00 00 00 00 00 00 23 18 18 18 18 18 18 18
18 18 18 18 18 18 18 18 24 00 00 00 00 00 00 00 00 00 00 07 02 06 00 00 00 00 00 00 00 00 00 00 00 00 00 00 00 00 00 00 00 00 00 00 00 00 00 00 00 00 00 00 00 00 00 00 00 00 00 23 18 18 18 18 18 18 18
18 18 18 18 18 18 18 18 24 00 00 16 16 16 16 16 00 00 00 07 02 06 00 00 00 00 00 00 00 00 00 00 00 00 00 00 00 00 00 00 00 00 00 00 00 00 00 00 00 00 00 00 00 00 00 00 00 00 00 23 18 18 18 18 18 18 18
18 18 18 18 18 18 18 18 24 00 00 16 17 17 17 16 00 00 00 07 02 06 00 00 00 00 00 00 00 00 00 00 00 00 00 00 00 00 00 00 00 00 00 00 00 00 00 00 00 00 00 00 00 00 00 00 00 00 00 23 18 18 18 18 18 18 18
18 18 18 18 18 18 18 18 24 00 00 16 17 17 17 16 00 00 00 07 02 06 00 00 00 00 00 00 00 00 00 00 00 00 00 00 00 00 00 00 00 00 00 00 00 00 00 00 00 00 00 00 00 00 00 00 00 00 00 23 18 18 18 18 18 18 18
18 18 18 18 18 18 18 18 24 00 00 16 17 17 17 16 00 00 00 07 02 06 00 00 00 00 00 00 00 00 00 00 00 00 00 00 00 00 00 00 00 00 00 00 00 00 00 00 00 00 00 00 00 00 00 00 00 00 00 23 18 18 18 18 18 18 18
18 18 18 18 18 18 18 18 24 00 00 16 16 17 16 16 00 00 00 07 02 06 00 00 00 00 00 00 00 00 00 00 00 00 00 00 00 00 00 00 00 00 00 00 00 00 00 00 00 00 00 00 00 00 00 00 00 00 00 23 18 18 18 18 18 18 18
18 18 18 18 18 18 18 18 24 00 00 00 00 00 00 00 00 00 00 07 02 06 00 00 00 00 00 00 00 00 00 00 00 00 00 00 00 00 00 00 00 00 00 00 00 00 00 00 00 00 00 00 00 00 00 00 00 00 00 23 18 18 18 18 18 18 18
18 18 18 18 18 18 18 18 24 00 00 00 00 00 00 00 00 00 00 07 02 06 00 00 00 00 00 00 00 00 00 00 00 00 00 00 00 00 00 00 00 00 00 00 00 00 00 00 00 00 00 00 00 00 00 00 00 00 00 23 18 18 18 18 18 18 18
18 18 18 18 18 18 18 18 24 00 00 00 00 11 09 09 09 09 09 10 02 06 00 00 00 00 00 00 00 00 00 00 00 00 00 00 00 00 00 00 00 00 00 00 00 00 00 00 00 00 00 00 00 00 00 00 00 00 00 23 18 18 18 18 18 18 18
18 18 18 18 18 18 18 18 24 00 00 00 00 07 02 02 02 02 02 02 02 06 00 00 00 00 00 00 00 00 00 00 00 00 00 00 00 00 00 00 00 00 00 00 00 00 00 00 00 00 00 00 00 00 00 00 00 00 00 23 18 18 18 18 18 18 18
18 18 18 18 18 18 18 18 24 00 00 00 00 13 04 04 04 04 04 04 04 14 00 00 00 00 00 00 00 00 00 00 00 00 00 00 00 00 00 00 00 00 00 00 00 00 00 00 00 00 00 00 00 00 00 00 00 00 00 23 18 18 18 18 18 18 18
18 18 18 18 18 18 18 18 30 21 21 21 21 21 21 21 21 21 21 21 21 21 21 21 21 21 21 21 21 21 21 21 21 21 21 21 21 21 21 21 21 21 21 21 21 21 21 21 21 21 21 21 21 21 21 21 21 21 21 31 18 18 18 18 18 18 18
18 18 18 18 18 18 18 18 18 18 18 18 18 18 18 18 18 18 18 18 18 18 18 18 18 18 18 18 18 18 18 18 18 18 18 18 18 18 18 18 18 18 18 18 18 18 18 18 18 18 18 18 18 18 18 18 18 18 18 18 18 18 18 18 18 18 18
18 18 18 18 18 18 18 18 18 18 18 18 18 18 18 18 18 18 18 18 18 18 18 18 18 18 18 18 18 18 18 18 18 18 18 18 18 18 18 18 18 18 18 18 18 18 18 18 18 18 18 18 18 18 18 18 18 18 18 18 18 18 18 18 18 18 18
18 18 18 18 18 18 18 18 18 18 18 18 18 18 18 18 18 18 18 18 18 18 18 18 18 18 18 18 18 18 18 18 18 18 18 18 18 18 18 18 18 18 18 18 18 18 18 18 18 18 18 18 18 18 18 18 18 18 18 18 18 18 18 18 18 18 18
18 18 18 18 18 18 18 18 18 18 18 18 18 18 18 18 18 18 18 18 18 18 18 18 18 18 18 18 18 18 18 18 18 18 18 18 18 18 18 18 18 18 18 18 18 18 18 18 18 18 18 18 18 18 18 18 18 18 18 18 18 18 18 18 18 18 18
18 18 18 18 18 18 18 18 18 18 18 18 18 18 18 18 18 18 18 18 18 18 18 18 18 18 18 18 18 18 18 18 18 18 18 18 18 18 18 18 18 18 18 18 18 18 18 18 18 18 18 18 18 18 18 18 18 18 18 18 18 18 18 18 18 18 18
18 18 18 18 18 18 18 18 18 18 18 18 18 18 18 18 18 18 18 18 18 18 18 18 18 18 18 18 18 18 18 18 18 18 18 18 18 18 18 18 18 18 18 18 18 18 18 18 18 18 18 18 18 18 18 18 18 18 18 18 18 18 18 18 18 18 18